Agni-P.        	(PW) AGNIPURĀṆA in der Bibl. ind. 
Ait. Ār.       	(PW) AITAREYĀRAṆYAKA in der Bibl. ind. In der Regel citirt nach Seite und Zeile (KERN und ROTH). 
Ait. Br.       	(PW) AITAREYABRĀHMAṆA, Ausg. von HAUG. 
AK.            	(PW) AMARAKOŚA, Ausg. von LOISELEUR DESLONGCHAMPS. 
Alaṃkārar.     	[unknown]
Alaṃkāras.     	(PW?) ALAṂKĀRAŚEKHARA, lith. Ausg. Benares 1923 (TH. AUFRECHT und R. PISCHEL).
Alaṃkāraś.     	(PW) ALAṂKĀRAŚEKHARA, lith. Ausg. Benares 1923 (TH. AUFRECHT und R. PISCHEL).
Alaṃkārat.     	(PW) ALAṂKĀRATILAKA, Hdschr. (AUFRECHT). 
Alaṃkārav.     	(PW) ALAṂKĀRAVIMARŚINĪ von JAYARATHA, Deccan Coll. Hdschr. No. 230 (PISCHEL). 
Amaru          	(SCH) Amaru(śatakam) ed. Simon und ed. Kāvyamālā.
Amit.          	(SCH) Amit(agati), Subhāsitasamdoha ed. Hertel u. Schmidt, ZDMG 59. 61.
Ānandal.       	(PW) ĀNANDALAHARĪ in HAEBELIN's Anthologie. 
Anarghar.      	(PW) ANARGHARĀGHAVA, Calcutta Śaka 1782 (AUFRECHT). 
Anarghar. S.   	[unknown]
Anarghyar.     	[unknown]
Anir.          	[unknown]
Antyeṣṭik.     	(PW) [unknown literary source]
Anukr.         	[unknown]
Āpast.         	(PW) ĀPASTAMBA'S DHARMASŪTRA, Ausg. von BÜHLER. 
Āpast. Gṛhy.   	(PW) [unknown literary source]
Āpast. Gṛhyas. 	[unknown]
Āpast. Śr.     	(PW) ĀPASTAMBA'S ŚRAUTASŪTRA, Hdschr. (GARME und ROTH). 
Ārṣ. Br.       	(PW) ĀRṢEYABRĀHMAṆA, Ausg. von BURNELL. 
Āśv. Gṛhy.     	(PW) ĀŚVALĀYANA'S GṚHYASŪTRA; Ausg. von STENZLER. 
Āśv. Śr.       	(PW) ĀŚVALĀYANA's ŚRAUTASŪTRA in der Bibl. ind. 
Aśvav.         	(PW) [unknown literary source]
Ath. Anukr.    	[unknown]
Ath. Paddh.    	[unknown]
Ath. Paddhati  	[unknown]
Ath. Par.      	[unknown]
Ath. Pariś.    	[unknown]
AV.            	(PW) ATHARVAVEDA, Ausg. von ROTH und WHITNEY (ROTH). 
AV. Anukr.     	(PW) [unknown literary source]
AV. Paipp.     	(PW) AV. der PAIPPALĀDA-Schule, Hdschr. (ROTH). 
AV. Pariś.     	(PW) PARIŚIṢṬA zum AV. , Hdschr. (ROTH). 
AV. Prāt.      	(PW) [unknown literary source]
Bādar.         	(PW) BĀDARĀYAṆA'S BRAHMASŪTRA in der Bibl. ind. 
Badar.         	[unknown]
Bālar.         	(PW) BĀLARĀMĀYAṆA, Benares 1869 (KERN). 
Baudh.         	(PW) BAUDHĀYANA, nach Citaten in andern Werken. 
Baudh. Gṛhy.   	[unknown]
Baudh. Gṛhy. Pariś.	(PW) [unknown literary source]
Benf. Chr.     	(PW) BENFEY'S Chrestomathie. 
Bhadrab.       	(PW) BHADRABĀHUCARITRA, herausgegeben von H. Y. JACOBI in Z. d. d. m. G. 38, 19. fgg. (JACOBI). 
Bhag.          	(PW) BHAGAVADGITĀ, Ausg. von SCHLEGEL. 
Bhāg. P.       	(PW) BHĀGAVATAPURĀṆA. Die 9 ersten Skandha nach BURNOUF's. Ausgabe, wenn nicht ausdrücklich. ed. Bomb. hinzugefügt wird; die letzten Skandha nach der ed. Bomb. In Klammern eingeschlossene Zahlen verweisen auf ed. Bomb. 
Bhām. V.       	(PW) BHĀMINĪVILĀSA, Ausg. von ABELBERGAIGNER(CAPELLER. ) 
Bhānudatta's Alaṃkāratilaka	(SCH) Bhānudatta's Alaṃkāratilakam, Abschrift eines Ms. ans Islampurkar's Besitz. Vgl. Festschrift Jacobi.
Bhar. Nāṭyaś.  	(PW) [unknown literary source]
Bhāradvājagṛhy.	[unknown]
Bhārat.        	[unknown]
Bhārata, Nāṭyaś.	[unknown]
Bhāratīyanāṭyaś.	[unknown]
Bhāṣāp.        	(PW) BHĀṢĀPARICCHEDA in der Bibl. ind. 
Bhaṭṭ.         	(PW) BHAṬṬIKĀVYA, Calcutta 1828. 
Bhāvapr.       	(PW) BHĀVAPRAKĀŚA, Calcutta 1875 und Hdschr. (ROTH). 
Bhāvat.        	[unknown]
Bhaviṣyap.     	(PW) BHAVIṢYAPURĀṆA Hdschr. (AUFRECHT). 
Bhikṣāṭanakāvya	[unknown]
Bhoja-Pr.      	(PW) BHOJAPRABANDHA, Benares 1925(KERN). 
Bibl. ind.     	(PW) Bibliotheca indica. 
Bibl. Ind.     	(PW) Bibliotheca indica. 
Bodhicaryāv.   	[unknown]
Bodhicaryāvatāra	[unknown]
Boll.          	[unknown]
Brahma-P. Uttarakh.	[unknown]
Brāhmaṇādhy.   	[unknown]
Brahmap.       	[unknown]
Brahmav. P.    	[unknown]
Brahmavaiv.    	[unknown]
Brahmavaiv. P. 	(PW) BRAHMAVAIVARTAPURĀṆA. 
Bṛh. Ār. Up.   	(PW) BṚHADĀRAṆYAKOPANIṢAD in der Bibl. ind. 
Bṛh. Ār. Up. S.	[unknown]
Bṛhanm.        	(PW) BṚHANMANU, nach Citaten in verschiedenen juristischen Büchern(JOLLY). 
Bṛhasp.        	(PW) BṚHASPATI, nach Citaten in verschiedenen jurischen Büchern (JOLLY). 
Bṛhatkathām.   	[unknown]
Bṛhatkathāmañjarī	[unknown]
BSB.           	[unknown]
Bühler, Rep.   	(PW) Detailed Report of a Tour in search of Sanskrit Mss. made. in Kāsmir, Rajputana, and Central India. By G. BÜHLER, Bombay 1877. 
Caṇḍak.        	(PW) KṢEMĪŚVARA'S CAṆḌAKAUŚIKA (PISCHEL). 
Caṇḍīś.        	[unknown]
Caṇḍiś.        	[unknown]
Caraka         	(SCH) Caraka (ed. Debendra Nath Sen und Upendra Nath Sen, soweit es sich um meine eigenen Angaben handelt).
Caurap. (A.)   	(PW) [unknown literary source]
Chānd. Up.     	(PW) CHĀNDOGYOPANIṢAD in der Bibl. ind. 
Chāndogyap.    	[unknown]
Chr.           	(PW) BÖHTLINGK'S Sanskrit-Chresthomathie, 2te Aufl. 
Colebr. Alg.   	(PW) COLEBROOKE, Algebra with Arithmetic and Mensuration u. s. w. London 1817. 
Colebr. Misc. Ess.	(PW) Miscellaneous Essays by H. T. COLEBROOKE. London. 1837. 
Damayantīk.    	(PW) [unknown literary source]
Dārila         	(PW) [unknown literary source]
Darpad.        	(PW) DARPADALANA von KṢEMENDRA, Hdschr. (AUFRECHT). 
Daśa K.        	[unknown]
Daśak.         	(PW) DAŚAKUMĀRA, Ausg. von BÜHLER (CAPELLER). 
Daśak. Pūrvap. 	[unknown]
Daśar.         	(PW) DAŚARŪPA in der Bibl. ind. 
Daśāv.         	(SCH) Daśāv(atāracaritam) nach J. J. Meyer's Angaben in seiner Übersetzung des Kuṭṭanīmatam.
Daśav.         	[unknown]
Dattakaś.      	(PW) DATTAKAŚIROMAṆI, Calcutta 1867 (JOLLY). 
Dattakatilaka  	[unknown]
Dāy.           	(PW) DĀYABHĀGA, Calcutta 1829. 
Deśīn.         	(PW) HEMACANDRA'S DEŚĪNĀMĀLĀ, Hdschr. (PISCHEL). 
Deśīn. S.      	[unknown]
Devībhāg.      	[unknown]
Dharm.         	[unknown]
Dharmaś.       	[unknown]
Dharmaśarm.    	[unknown]
Dharmaśarmābhy.	[unknown]
Dhātup.        	(PW) DHĀTUPĀṬHA, Ausg. von WESTERGAARD. 
Dhātupārāyaṇa  	[unknown]
Dhvanyāloka    	[unknown]
Dināl.         	[unknown]
Dināl.-Śuk.    	[unknown]
Divyāv.        	[unknown]
Divyāvad.      	(PW) DIVYĀVADĀNA, Hdschr. (SCHIEFNER). 
Divyāyad.      	[unknown]
Dravyaś.       	[unknown]
Eggeling, Cat. 	[unknown]
Eggeling, Catal.	[unknown]
Gal.           	(PW) GALANOS's Wörterbuch, Abschrift von WEBER;vgl. Monatsbericht der Kön. Pr. Akad. der Wissensch. 1876, S. 801. fgg. (CAPELLER). 
Gaṇap.         	[unknown]
Gaṇar.         	(PW) GAṆARATNAMAHODADHI, nach der im Druck befindlichen Ausg. von EGGELING. Nur ein paar Mal gelegentlich citirt. 
Garbhop.       	(PW) GARBHOPANIṢAD in Bibl. ind. (GELDNER und ROTH). 
Gaut.          	(PW) GAUTAMA'S DHARMAŚĀSTRA, Ausg. von STENZLER. 
Ghāṭe          	[unknown]
Gīt.           	(PW) GĪTAGOVINDA, Ausg. von LASSEN. 
Gītag.         	[unknown]
Gobh.          	(PW) GOBHILA'S GṚHYASŪTRA in der Bibl. ind. (ROTH). 
Gobh. Śrāddh.  	[unknown]
Gobh. Śrāddhak.	(PW) GOBHILA'S ŚRĀDDHAKALPA in der Bibl. ind. 
Gop.           	[unknown]
Gop. Br.       	(PW) GOPATHABRĀHMAṆA in der Bibl. ind. (ROTH). 
Gopāl.         	(SCH) Gopāl(akelicandrikā) ed. W. Caland, Amsterdam 1917. Wörterverzeichnis S. 151-152.
Govardh.       	(PW) Govardhana's SAPTAŚATĪ (WEBER) . 
Gṛhyās.        	(PW) GṚHYĀSAṂGRAHA in der Bibl. ind. 
Gṛhyas.        	[unknown]
H              	[unknown]
H. an.         	(PW) HEMACANDRA'S ANEKĀRTHASAṂGRAHA. 
H. Deś.        	[unknown]
Haeb. Chr.     	[unknown]
Halāy.         	(PW) HALĀYUDHA'S Wörterbuch, Ausg. von AUFRECHT. 
Har.           	[unknown]
Hār.           	(PW) HĀRĀVALI. 
Hārītasaṃh.    	[unknown]
Hariv.         	(PW) HARIVAṂŚA. Mit einer Zahi die ältere Calc. Ausg. gemeint, drei Zahlen die neuere lithographirte. 
Harṣ.          	[unknown]
Harṣac.        	(PW) HARṢACARITA, Calcutta 1876 (KERN). 
Hem. Abhidhānac.	[unknown]
Hem. An.       	[unknown]
Hem. Anek.     	[unknown]
Hem. Deś.      	[unknown]
Hem. Par.      	(PW) HEMACANDRA'S PARIŚIṢṬAPARVAN, Hdschr. (JACOBI). 
Hem. Pr. Gr.   	(PW) [unknown literary source]
Hem. Prākr.    	[unknown]
Hem. Uṇ.       	[unknown]
Hem. Uṇādis.   	[unknown]
Hem. Yog.      	(PW) HEMACANDRA'S YOGAŚĀSTRA in Z. d. d. m. G. 28. Aus einem hdschr. Comm. hat WINISCH manche Berichtigung und Erklärung mir bereitwilligst zukommen lassen. 
Hem. Yogaś.    	(PW) [unknown literary source]
Hem. Yogay.    	[unknown]
Hiouen-Thsang. 	[unknown]
Hiraṇy. Śr.    	[unknown]
Hit.           	(PW) HITOPADEŚA, Ausg. von SCHLEGEL und LASSEN. 
Ind. Antiq.    	(PW) Indian Antiquary (ROTH). 
Ind. Erb.      	[unknown]
Ind. St.       	(PW) Indische Studien von WEBER. 
Ind. Str.      	[unknown]
Ind. Stud.     	[unknown]
Ind. Studien   	[unknown]
Indian Antiquary	[unknown]
J. J. Meyer    	[unknown]
Jaim.          	(PW) JAIMINI'S Mimāṃsādarśana in der Bibl. ind. 
JAOS, Proc.    	[unknown]
JAOS.          	[unknown]
JAOS. Proc.    	[unknown]
JAS. Beng.     	[unknown]
Jātakam.       	(PW) JĀTAKAMĀLĀ, Hdschr. (H. KERN). 
JRAS           	[unknown]
JRAS. Beng.    	[unknown]
Kād.           	(PW) KĀDAMBARĪ, Calcutta Saṃvat 1919 (KERN). 
Kālac.         	(PW) KĀLACAKRA, Hdschr. (SCHIEFNER). 
Kalāv.         	(SCH) Kalāv(ilasa) ed. Kāvyamālā, Part I, p. 34 ff.
Kalāvil.       	[unknown]
Kalpas.        	(PW) KALPASŪTRA, herausg. von H. JACOBI (JACOBI und KERN). 
Kām. Nītis.    	(PW) KĀMANDAKĪYANĪTISĀRA in der Bibl. ind. 
Kāmas.         	[unknown]
Kaṃs.          	(SCH) Kaṃs(avadha) ed. Nirṇayasāgara-Press, Bombay 1888. (Kāvyamālā Nr. 6.)
Kandarp.       	[unknown]
Kap.           	(PW) KAPILA'S SĀṂKHYAPRAVACANA. Einen vollständigen Index hat WINDISCH ZU Verfügung gestellt. 
Kap. S.        	(PW) KAPIṢṬHALAKAṬHASAṂHITA, Hdschr. (v. SCHRÖDER). 
Kār.           	[unknown]
Kāraṇḍ.        	(PW) KĀRAṆḌAVYŪHA, Calcutta 1873(KERN). 
Kāraṇḍavy.     	[unknown]
Karmapr.       	(PW) KARMAPRADĪPA (STENZLER). Steht unter dem falschen Titel KĀTYĀYANASMṚTI im DHARMAŚĀSTRASAṂGRAHA, Vol. I, S 603-644. 
Karṇas.        	(SCH) Karṇas(undarī) ed. Kāvyamālā Nr. 7, Bombay 1888.
Kāś.           	(PW) KĀŚIKĀ VṚTTI in der Zeitschrift The PANDIT VII. fgg. 
Kāśīkh.        	(PW) KĀŚĪKHAṆḌA, HDSCHR. (AUFRECHT). 
Kaśm. Ś.       	[unknown]
Kaśm. Śiv.     	[unknown]
Kāt.           	(PW) KĀTANTRA, heraugsgegeben von EGGELING. 
Kāṭh.          	(PW) KĀṬHAKA (WEBER). 
Kathāk.        	(SCH) Kathāk(autukam) meine Ausgabe, Kiel 1898.
Kathākaut.     	[unknown]
Kathākautukam  	[unknown]
Kathās.        	(PW) KATHĀSARITSĀGARA, Ausg. von BROCKHAUS. 
Kaṭhop.        	(PW) KAṬHOP(ANIṢAD) in der Bibl. ind. 
Kāty.          	(PW) KĀTYĀYANA'S PARIBH (ĀṢĀS) IN 'Zwölf Hymnen des Rigveda, herausgegeben von ERNST WIDISCH'S. 169. fgg. 
Kāty. Śr.      	(PW) KĀTYĀYANA'S ŚRAUTASŪTRA, nach WEBER'S Index. 
Kāty. Śrāddhak.	[unknown]
Kauś.          	(PW) KAUŚIKA'S SŪTRA zum AV. , Hdschr. (ROTH und WEBER). 
Kaus.          	[unknown]
Kaus. Up.      	[unknown]
Kauṣ. Up.      	(PW) KAUṢITAKIBRĀHMAṆOPANIṢAD in der Bibl. ind. 
Kauśikasūtra   	[unknown]
Kaut.          	(SCH) Kaut(ilīyam Arthaśāstram), Jolly's Liste IF 31, 204 ff. M = ed. 1909; A = Münchener Ms Nr. 334, B = Nr. 335.
Kauṭ.          	(SCH) Kauṭ(ilīyam Arthaśāstram ed. Mysore 1909) an der Hand der Übersetzung von J. J. Meyer. Benutzt bis S. 173 des Sanskrittextes.
Kautukar.      	(PW) KAUTUKARATNĀKARA, Hdschr. (CAPELLER). 
Kautukas.      	(PW) [unknown literary source]
Kāvyād.        	(PW) [unknown literary source]
Kāvyāl.        	(PW) KĀVYĀLOKALOCANA, Hdschr. (AUFRECHT). 
Kāvyamālā      	[unknown]
Kāvyapr.       	(PW) KĀVYAPRAKĀŚA, Calcutta 1866. Nach Ullāsa und Sūtra citirt, wenn nicht S. (Seite) und Z. (Zeile) hinzungefügt werden. 
Kenop.         	(PW) KENOPANIṢAD in der Bibl. ind. 
Khaṇḍapr.      	[unknown]
Kir.           	(PW) KIRĀTĀRJUNIYA, Calcutta 1814. 
Kirāt.         	[unknown]
Kṣem.          	(PW) KṢEMENDRA'S KAVIKAṆṬĀBHARAṆA, herausgegeben von Y. SCHÖNBERG in den Sitzungsberichten der Phil-hist. Klasse der Kais. Ak. d. Ww. in Wien, Bd. 106 (C. CAPELLER). 
Kṣurikop.      	(PW) KṢURIKOPANIṢAD in der Bibl. ind. 
Kuhn's Z.      	(PW) Zeitschrift für vergleichende Sprachforschung anf dem Gebiete der indogermanischen Sprachen. 
Kull.          	(PW) KULLŪKA, Commentator des MANU. 
Kumāras.       	(PW) KUMĀRASAṂBHAVA, Ausg. von STENZLER. 
Kusum.         	(PW) KUSUMĀÑJALI, Ausg. von COWELL. 
Kuṭṭ.          	(SCH) Kuṭṭ(anīmatam) ed. Kāvyamālā. (Nach J. J. Meyer.)
Kuṭṭanīm.      	[unknown]
Kuval.         	(SCH) Kuval(ayānandakārikā) ed. Bombay, NSP, śak. 1808.
LA.            	(PW) LASSEN'S Anthologie 3te Ausg. 
Laghuk.        	(PW) LAGHUKAUMUDĪ, Ausg. von BALLANTYNE, Benares 1876(CAPELLER). 
Lakṣmaṇasūri   	[unknown]
Lalit.         	(PW) LALITAVISTARAPURĀṆA in der Bibl. ind. (KERN). 
Laṭ.           	(SCH) Laṭ(akamelakam) ed. Kāvyamālā Nr. 20.
Lāṭy.          	(PW) LĀṬYĀYANA'S ŚRAUTASŪTRA in der Bibl. ind. 
Leumann.       	[unknown]
Līlāv.         	(PW) BHĀSKARA'S LĪLĀVATĪ, Calcutta 1846 (KERN). 
Līlāv. S.      	[unknown]
Liṅg.          	[unknown]
Lot. de la b. l.	(PW) BURNOUF, Lotus de la bonne loi. 
M.             	(PW) MĀNAVADHARMAŚĀSTRA. 
M. Müller, Ren.	(PW) The Renaissance of Sanskrit Literature in M. MüLLER'S India what can it teach us? S. 281. fgg. Auch die vorangehenden Abschnitte werden so citirt. 
Madanav.       	(PW) MADANAPĀLA'S MADANAVINODA, Benares 1869 und Hdschr. (ROTH). 
Mahābh.        	(PW) MAHĀBHĀṢYA, lith. in Benares. 
Mahābh. (K.)   	(PW) KIELHORN'S Ausg. des MAHĀBHĀṢYA. 
Mahābhy.       	[unknown]
Mahād.         	[unknown]
Mahāparin.     	[unknown]
Mahāv.         	[unknown]
Mahāvīr.       	(SCH) Mahāvīr(acaritam) ed. Aiyar, Bombay 1901 und ed. Lakṣmaṇasūri, new edition, Madras 1904.
Mahavīr.       	[unknown]
Mahāvīr. ed. Aiyar	(SCH) Mahāvīr(acaritam) ed. Aiyar, Bombay 1901 und ed. Lakṣmaṇasūri, new edition, Madras 1904.
Mahāvīrac.     	(PW) MAHĀVĪRACARITA, Ausg. von TRITHEN. 
Mahāvīrāc.     	[unknown]
Mahāvīrac. ed. Aiyar	(SCH) Mahāvīr(acaritam) ed. Aiyar, Bombay 1901 und ed. Lakṣmaṇasūri, new edition, Madras 1904.
Mahāvy.        	[unknown]
Mahavy.        	[unknown]
Mahāvyut.      	[unknown]
Mahīdh.        	(PW) MAHĪDHARA, Commentator der VS. 
Maitr.         	[unknown]
Maitr. S.      	(PW) MAITRĀYAṆI SAṂHITĀ, zur Herausgabe vorbereitet von L. SCHRÖDER. Da die accentuirten Hdschr. nicht gleich zu Anfang zur Hand waren, konnten einige Accente erst in den Nachträgen angegeben werden (SCHRÖDER). 
Maitryup.      	(PW) MAITRYUPANIṢAD in der Bibl. ind. Die Accente, die wegen ihrer Fehlerhaftigkeit oft weggelassen oder durch (!) als verdächtig bezeichnet wurden, hat SCHRÖDER einer Hdschr. entnommen. 
Mālatīm.       	(PW) MĀLATĪMĀDHAVA, nach zwei Ausgaben, Calcutta 1830 und Bombay 1876. 
Mālatīm. (B. S. S.)	[unknown]
Mālav.         	(PW) MĀLAVIKĀGNIMITRA, Ausg. von TULLIBERG. 
Mālavik.       	[unknown]
Mallin.        	(PW) [unknown literary source]
Mān. Gṛhy.     	(PW) MĀNAVAGṚHYASŪTRA, nach einer Hdschr. in der Universitätsbibliothek zu Bombay (SCHRÖDER). 
Mān. Śr.       	(PW) MĀNAVAŚRAUTASŪTRA, Hdschr. (v. SCHRÖDER). 
Māṇḍ. Up.      	(PW) MĀṆḌŪKYOPANIṢAD in der BIbl. ind. 
Manm.          	[unknown]
Manmatk.       	(SCH) Manmatk(onmathana), meine Ausgabe ZDMG 63.
Mārk. P.       	(PW) MĀRKAṆḌEYAPURĀṆA in der Bibl. ind. 
Mat. med.      	(PW) The Materia medica of the Hindus compiled from Sankr. medical works by UDOY CHAND DUTT Civil Medicinal officer. With a Glossary of Indian Plants by GE. KING. Superint. R. Bot. Garden Calc. and the author. Calcutta 1877. 
Matsya-P.      	(PW) MATSYAPURĀṆA, Poona-Ausg. (AUFRECHT). 
Matsyap.       	(PW) MATSYAPURĀṆA, Poona-Ausg. (AUFRECHT). 
MBh.           	(PW) MAHĀBHĀRATA, citirt nach Parvan, Adhyāya und Śloka der Bomb. Ausg. Die ältere Calcuttaer Ausg. mit zwei Zahlen wird nur dann angeführt, wenn sie eine abweichende Lesart bietet. 
MBh. ed. Vardh.	(PW) MBH. ed. Vardh. ist die auf Kosten des Fürsten von Vardhamāna (Burdwan) gedruckte Ausg. des MAHĀBHĀRATA. Sie enthält nur die 12 ersten Parvan. 
Med.           	(PW) MEDINIKOŚA. 
Med. k.        	(PW) [unknown literary source]
Medhāt.        	(PW) MEDHĀTITHI, ein Scholiast des MANU (JOLLY). 
Megh.          	(PW) MEGHADŪTA, Ausg. von STENZLER. 
Mgs.           	(SCH)  Mgs. = Mānavagṛhyasūtra ed. Knauer.
Mon. d. B. A.  	(PW) Monatsberichte der Königlich Preussichen Akademie der Wissenschaften in Berlin. 
Monatsb. d. B. A.	[unknown]
Mṛcch.         	(PW) MṚCCHAKAṬIKA, Ausg. von STENZLER. Comm. zu MṚCCH. sind die Auszüge in den Anmerkungen zu meiner Uebersetzung dieses Schauspiels. 
Mudrār.        	(PW) MUDRĀRĀKṢASA, nach zwei Ausgaben, Calcutta 1831 und 1926 (CAPELLER). 
Muk.           	(SCH) Muk(undānandabhāṇa) ed. Kāvyamālā Nr. 16.
Muṇḍ.          	[unknown]
Nāgān.         	(PW) NĀGĀNANDA nach zwei Calcuttaer Ausgaben (CAPELLER) 
Naiṣ.          	(PW) NAIṢADHACARITA. 
Nais.          	[unknown]
Nandap.        	[unknown]
Nār.           	(PW) NĀRADA'S DHARMAŚĀSTRA (JOLLY). 
Nārada (a.)    	(PW) bezeichnet die ausführlichere Recension NĀRADA'S (JOLLY). 
Navasāhas.     	[unknown]
Nigh.          	(PW) YĀSKA'S NIRUKTA sammt den NIGHAṆṬAVAS, herausgegeben und erläutert von RUDOLPH ROTH. 
Nigh. Pr.      	(PW) NIGHAṆṬUPRAKĀŚA (ROTH). 
Nīlak.         	(PW) NĪLAKAṆṬHA, Commentator des MBH. 
Nir.           	(PW) NIRUKTA, Ausg. von ROTH (ROTH). 
Nyāyāk.        	[unknown]
Nyāyak. Sāṃkhapr.	[unknown]
Nyāyam.        	(PW) JAIMINIYANYĀYAMĀLĀVISTARA, Ausg. von GOLDSTÜCKER UND Cowell (KERN). 
Opp. Cat.      	(PW) List of Sanskrit Manuscripts in Private libraries of southern India. Compiled, arranged and indexed by GUSTAV OPPERT. 
P.             	(PW) PĀṆINI. 
Padap.         	[unknown]
Pādāravindaś.  	[unknown]
Pādāravindaśat.	[unknown]
Pādāravindaśataka	[unknown]
Paddh.         	(PW) PADDHATI zu MĀN (AVA) GṚHY (ASŪTRA), Hdschr. (v. BRADKE). 
Padyac.        	(SCH) Padyac(ūḍāmani) ed. Madras 1921.
Pañc.          	[unknown]
Pañcad.        	(PW) PAÑCADAṆḌACCHATTRABANDHA, herausg. von WEBER. 
Pañcadaṇḍacch. 	[unknown]
Pañcar.        	(PW) NĀRADA'S PAÑCARĀTRA in der Bibl. ind. 
Pañcat.        	(PW)  ohne nähere Angabe PAÑCATANTRA, vollständige Ausg. von KOSEGARTEN. Mit Beifügung von ed. Bomb. --die Ausg. von BÜHLER und KIELHORN. 
Pār. Gṛhy.     	(PW) PĀRASKARA'S GṚHYASŪTRA, Ausg. von STENZLER. 
Par. Sār.      	(SCH) Par. Sār. = The Paramārtha Sāra (The Kashmir Series of Texts and Studies edited by J. C. Chatterji, Srinagar 1911 ff., Vol. VII).
Par. Tr.       	(SCH) Par. Tr. = The Parā Trimsika (Vol. XXI in voriger Serie).
Parāś.         	(PW) PARĀŚARA'S DHARMAŚĀSTRA (STENZLER). 
Parāśara       	(PW) [unknown literary source]
Parāśarasaṃhitā	[unknown]
Paribh.        	(PW) PARIBHĀṢĀ in PARIBHĀṢENDUŚEKHARA, Ausg. von KIELHORN. 
Pārijātam.     	(SCH) Pārijātam(añjarī) ed. Hultzsch, Leipzig 1907.
Pārśvan.       	(PW) PĀRŚVANĀTHAKĀVYA, Hdschr. (AUFRECHT). 
Pārv.          	[unknown]
Pārvat.        	(SCH) Pārvat(īpariṇayanātakam), meine Ausgabe (AKM XIII, 4; Leipzig 1917).
Pat.           	(PW) Patañjali [unknown literary source]
Pischel, BB.   	[unknown]
Pischel, de Gr. pr.	(PW) PISCHEL, de Grammaticis prācriticis. Vratislaviae 1874. 
Pischel, Ved. St.	[unknown]
Pischel, Ved. Stud.	[unknown]
Pischel, Ved. Studien	[unknown]
Pr. P.         	(PW) PRACAṆḌAPĀṆḌAVA, EIN SCHAUSPIEL. HDSCHR. (CAPELLER). 
Prab.          	(PW) PRABODHACANDRODAYA, Ausg. von BROCKHAUS. 
Prabandh.      	(SCH) Prabandh(acintāmani) ed. Dīnānātha, Bombay 1888. "Tawney" bezeichnet seine englische Übersetzung, Calcntta 1901.
Prasannar.     	(PW) JAYADEVA'S PRASANNARĀGHAVA (KERN). 
Pratāpar.      	(PW) PRATĀPARUDRIYA. 
Pratijñās.     	(PW) PRATIJÑĀS(ŪTRA) berausg. von A. WEBER. 
Praty. Hṛd.    	(SCH) Praty. Hṛd. = Pratyabhijñā Hṛdaya (Vol. III der Kashmir Series).
Prāyaścittav.  	[unknown]
Priy.          	(PW) PRIYADARŚIKĀ, Calcutta 18?? (CAPELLER). 
Priyad.        	[unknown]
Proc. A. O. S. 	[unknown]
Proc. of the As. Soc. of Bengal	[unknown]
Pūrṇabh.       	(SCH) Pūrṇabh(adra), nach Hertel's Liste in dessen Ausgabe.
Pūrṇābh.       	[unknown]
R.             	(PW) RĀMĀYAṆA. Das 1ste und 2te Kāṇḍa nach der Ausg. von SCHLEGEL, das 3--6te nach der von GORRESIO, das 7te nach der Bomb. Ausg., wenn nicht ausdrücklich eine andere Ausgabe genannt ist. Eine eingeklammerte Zahl bezieht ist sich auf ed. Bomb. 
R. ed. Bomb.   	(PW) [unknown literary source]
R. Gorr.       	(PW)  RĀMĀYAṆA, translation by Gaspare Gorresio. [Cologne Addition]
Ragh.          	(PW) RAGHUVAṂŚA, Ausg. von STENZLER, wenn nicht ed. Calc. hinzuge- fügt wird. 
Raghuv.        	[unknown]
Rājan.         	(PW) RĀJANIGHAṆṬU, Hdschr. (ROTH). 
Rājat.         	(PW) RĀJATARAṂGIṆĪ. Die 6 ersten Bücher nach der Ausg. von TROYER. Die Beträge aus dem 7ten und 8ten Buche von KERN. 
Rāmat.         	[unknown]
Rasas.         	(SCH) Rasas(adanabhāṇa) ed. Kāvyamālā Nr. 37.
Rasikar.       	[unknown]
Rasikarañjana  	[unknown]
Ratnam.        	(PW) RATNAMĀLĀ. (ROTH). 
Ṛtus.          	(PW) RṬUSAṂHĀRA, Ausg. von BOHLEN. 
Ṛtusaṃh.       	[unknown]
Rudraṭa, Kāvy. 	[unknown]
Rudraṭālaṃkārat.	[unknown]
Rudraṭālaṃkāraṭ.	(PW) RUDRAṬĀLAṂKĀRAṬIPPAṆAKA, auch RUDRAṬAKĀVYĀLAṂKĀRAṬ. genannt (R. PISCHEL. ) 
ṚV.            	(PW) ṚGVEDA (ROTH). 
ṚV. Prāt.      	(PW) PRĀTIŚĀKHYA zum ṚGVEDA. 
S              	[unknown]
S. S. S.       	(PW) SAṂGITASĀRASAṂGRAHA, Calcutta 1932 (CAPELLER). 
Śabdar.        	[unknown]
Saddh. P.      	(PW) SADDHARMAPUṆḌARĪKA (KERN) . 
Ṣaḍguruś.      	[unknown]
Sādh.          	[unknown]
Saduktik.      	(PW) SADUKTIKARṆĀMṚTA von ŚRĪDHARADĀSA, Hdschr. (AUFRECHT). 
Ṣaḍv. Br.      	(PW) ṢAḌVIṂŚABRĀHMAṆA (WEBER). 
Sāh. D.        	(PW) SĀHITYADARPAṆA in der Bibl. ind. 
Sāhityad.      	[unknown]
Sāhityadarpaṇa 	[unknown]
Śāk.           	(PW) ŚĀKUNTALA, Ausg. von BÖHTLINGK, wenn nicht ausdrücklich PISCH. (PISCHEL) oder PRAMAC. (PREMACANDRA) hinzugefügt wird. 
Śāk. (Ch.)     	(PW) [unknown literary source]
Śāk. (Kāśm.)   	[unknown]
Śāk. Ch.       	(PW) [unknown literary source]
Śāktān. Kap.   	[unknown]
Sam.           	[unknown]
Sāmav. Br.     	(PW) SĀMAVIDHĀNABRĀHMAṆA, Ausg. von BURNELL. 
Samay.         	(SCH) Samay(amātṛkā) ed. Kāvyamālā Nr. 10. Mit Benutzung natürlich von J. J. Meyers Übersetzung. Sarasv(atlkaṇthābharaṇam).
Samayam.       	[unknown]
Saṃhitop.      	[unknown]
Saṃhitopan.    	(PW) SAṂHITOPANIṢAD, Ausg. von BURNELL. 
Śaṃk.          	(PW) ŚAṂKARĀCĀRYA als Commentator verchiedener UPANIṢAD. 
Śaṃkaramiśra.  	[unknown]
Sāṃkhyak.      	(PW) SĀṂKHYAKĀRIKĀ, Ausg. von WILSON. 
Sāṃkhyakār.    	[unknown]
Sāṃkhyapr.     	(PW) [unknown literary source]
Sāṃkhyas.      	[unknown]
Sāṃkhyatattvak.	[unknown]
Saṃkṣepaś.     	[unknown]
Saṃsk. K.      	(PW) ANANTADEVA'S SAṂSKĀRAKAUSTUBHA, obl. fol. 
Śāṇḍ.          	(PW) The Aphorisms of SĀṆḌILYA in der Bibl. ind. 
Śāṅkh. Br.     	(PW) ŚĀṄKHĀYANA'S BRĀHMAṆA (WEBER). 
Śāṅkh. Gṛhy.   	(PW) ŚĀṄKHĀYANA'S GṚHYASŪTRA, herausg. von OLDENBERG in Ind. St. 15. 
Śāṅkh. Śr.     	(PW) ŚĀṄKHĀYANA'S ŚRAUTASŪTRA (WEBER). 
Sarasv.        	[unknown]
Sarasvatīk.    	(PW) SARASVATĪKAṆṬHĀBHARAṆA, Hdschr. (AUFRECHT). 
Sarasvatīkaṇṭh.	[unknown]
Śārṅg.         	[unknown]
Śārṅg. Saṃh.   	(PW) ŚĀRṄGADHARA'S SAṂHITĀ, Bombay 1853 (ROTH). 
Śārṅgadharap.  	[unknown]
Sarvad.        	(PW) SARVADARŚANASAṂGRAHA in der Bibl. ind. (KERN). 
Śāśv.          	[unknown]
Śat. Br.       	(PW) ŚATAPATHABRĀHMAṆA, nach WEBER'S Index. 
Śatr.          	(PW) ŚATRUṂJAYAMĀHĀTMYA, Ausg. von WEBER. 
Saug.          	(SCH) Saug(andhikākaraṇam) ed. Kāvyamālā Nr. 74, Bombay 1902.
Sāy.           	(PW) SĀYAṆA. 
Schl.          	[unknown]
Śīlāṅk.        	[unknown]
Śīlāṅka        	(PW) ŚĪLĀṄKA'S Commentar zum ĀCĀRĀṄGASŪTRA, Calcutta 1878 (JACOBI). 
Śiś.           	(PW) ŚIŚUPĀLAVADHA, Calcutta 1815. 
Śis.           	[unknown]
Śiśup.         	[unknown]
Śiv. Vim.      	(SCH) Śiv. Vim. = The Shiva Sūtra Vimarshinī (The Kashmir Series … Vol. I).
Śiva-P. (SK.)  	[unknown]
ŚKdr.          	(PW) ŚABDAKALPADRUMA. 
Śobh.          	[unknown]
Sobh.          	[unknown]
Spr.           	(PW) Indische Sprüche, herausg. von O. BÖHTLINGK. 2te Aufl. Von 7614 an in Melanges asiatiques, T. VIII, S. 217. fgg. Ebendaselbst S. 203. fgg. stehen die durch "zu Spr. " bezeichneten Varianten. 
Śrīk.          	(SCH) Śrīk(aṇthacaritam) ed. Kāvyamālā Nr. 3. Ist teilweise schon im pw verarbeitet.
Śrīkaṇṭh.      	[unknown]
Śrīkaṇṭhacarita	[unknown]
Śrīmālām.      	[unknown]
Śṛṅg.          	[unknown]
Śṛṅgārabh.     	[unknown]
Śṛṅgārasarv.   	(SCH) Śṛṅgārasarv(asvabhāṇa) ed. Kāvyamālā Nr. 78.
Sṛṅgārasarv.   	[unknown]
Śṛṅgārat.      	[unknown]
Śṛṅgāravairāgyataraṃgiṇī	[unknown]
Śṛṅgbh.        	(SCH) Śṛṅgbh = Śṛṅgārabiūsaṇabhāṇa ed. Kāvyamālā Nr. 58.
Śṛṅgsarv.      	[unknown]
Śṛṅgt.         	(SCH) Śṛṅgt = Śṛṅgāratilakabhāṇa ed. Kāvyamālā Nr. 44.
Śṛùgārasarv.   	[unknown]
Śrut.          	(PW) ŚRUTABODHA in der Zeitschrift für die Kunde des Morgenlandes, Bd. IV. 
Subhadr.       	(SCH) Subhadr(āharaṇa) ed. Kāvyamālā Nr. 9, Bombay 1888.
Subhāṣ.        	[unknown]
Subhāṣitar.    	(PW) SUBHĀṢITARATNĀKARA, Bombay 1872. 
Subhāṣitaratnabhāṇḍāgāra	[unknown]
Subhāṣitāv.    	(PW) SUBHĀṢITĀVALI von VALLABHADEVA, Hdschr. (AUFRECHT). 
Sud.           	(PW) [unknown literary source]
Śuk.           	(SCH) Śuk(asaptati) t(extus) s(implicior) resp. o(rnatior), meine Ausgaben.
Sukhāv.        	(PW) SUKHĀVATĪVYŪHA nach der nocht nich erschienenen Ausg. von F. MAX MÜLLER.
Śūlap. Prāyaśc.	[unknown]
Śulbas.        	(PW) ŚULBASŪTRA in der Zeitschirft The Pandit IX. X und New Series I (CAPELLER). 
Suparṇ.        	(PW) SUPARṆĀDHYA, herausg. von ELIMAR GRUBE in Ind. St. 14. 
Sūryaś.        	(SCH) Sūryaś(atakam) ed. Kāvyamālā Nr. 19.
Sūryas.        	(PW) SŪRYASIDDHĀNTA in der Bibl. ind. 
Suśr.          	(PW) SUŚRUTA (ROTRH). 
Svapnac.       	[unknown]
Śvetāśv. Up.   	(PW) ŚVETĀŚVATAROPANIṢAD in der Bibl. ind. 
T. S.          	[unknown]
Taitt. Ār.     	(PW) TAITTIRĪYĀRAṆYAKA in der Bibl. ind. 
Taitt. Br.     	[unknown]
Taitt. Up.     	(PW) TAITTIRĪYOPANIṢAD in der Bibl. ind. 
Talavakāra-Br. 	[unknown]
Tāṇḍya-Br.     	(PW) TĀṆḌYABRĀHMAṆA in der Bibl. Im grossen Wörterbuch als PAÑCAV. BR. citirt. 
Taṇḍya-Br.     	[unknown]
Tāran.         	[unknown]
Tarkas.        	(PW) TARKASAṂGRAHA, Allahabad 1849(ROTH). 
TBr.           	(PW) TAITTIRĪYA BRĀHMAṆA (ROTH). 
Tejob. Up.     	(PW) TEJOBINDŪPANIṢAD in der Bibl. ind. (GELDNER). 
Tithyād.       	[unknown]
Trik.          	(PW) TRIKĀṆḌAŚEṢA. 
TS.            	(PW) TAITTIRĪYASAṂHITĀ (ROTH und WEBER). 
TS. Prāt.      	(PW) PRĀTIŚĀKHYA zur TS. , Ausg. von WHITNEY. 
Ujjval.        	(PW) UJJVALADATTA, Commentator der UṆĀDISŪTRA. 
Uṇādis.        	(PW) UṆĀDISŪTRA, herausg. von AUFRECHT. 
Unm.           	[unknown]
Unmattar.      	(SCH) Unmattar(āghavam) ed. Kāvyamālā Nr. 17.
Unmattaragh.   	[unknown]
Uttamac.       	(PW) Ueber das UTTAMACARITRAKATHĀNAKAM, die Geschichte vom prinzen Trefflichst in Sitzungsserichte der Kön der Kön. Pr. Akademie der Ww- zu Berlin 1884, No. XVII. 
Uttar.         	[unknown]
Uttarac.       	[unknown]
Uttarādhy.     	[unknown]
Uttarar.       	(PW) UTTARARĀMACARITRA, nach zwei Ausgaben, Calcutta 1831 und 1862. 
Uttararāmach.  	[unknown]
V.             	(SCH) V(ātsyāyana's) Kāmasūtram. Die ed. Benares 1912 wird gelegentlich auch zitiert.
Vāgbh.         	(PW) VĀGBHAṬA'S ĀYURVEDADARŚANA (ROTH). 
Vāgbhaṭa       	(PW) [unknown literary source]
Vaij.          	(SCH) Vaij(ayantī) ed. Oppert.
Vaitān.        	(PW) VAITĀNASŪTRA, Ausg, von GARBE. 
Vaj.           	[unknown]
Vajracch.      	(PW) VAJRACCHEDIKĀ, herausgegeben von (F. MAX MÜLLER). 
Vall.          	(PW) [unknown literary source]
Vāmana, Kāvy.  	[unknown]
Vāmanap.       	[unknown]
Vāmanap. Kap.  	[unknown]
Var. Bṛh. S.   	[unknown]
Varāh. Bṛh.    	(PW) VARĀHAMIHIRA'S BṚHAJJĀTAKA (KERN). 
Varāh. Bṛh. S. 	(PW) VARĀHAMIHIRA'S BṚHATSAṂHITĀ (KERN). 
Varāh. Yogay.  	(PW) VARĀHAMIHIRA'S YOGAYĀTRĀ, herausg. von KERN in Ind. St. 10. 14 und 15. 
Varāhap.       	[unknown]
Varāhap. Kap.  	[unknown]
Vardhamānac.   	(PW) [unknown literary source]
Vās.           	(PW) VĀSANTIKĀ, Hdschr. (CAPELLER). 
Vāsav.         	(PW) VĀSAVADATTĀ in der Bibl. ind. 
Vasav.         	[unknown]
Vāsavad.       	[unknown]
Vāstuv.        	(PW) VIŚVAKARMA'S VĀSTUVIDYĀ, Hdschr (KERN). 
Vāyu-P.        	(PW) VĀYUPURĀṆA, nach Citaten in andern Werken. 
Vedārthad.     	[unknown]
Veṇīs.         	(PW) VEṆĪSAṂHĀRA, Ausg. von GRILL (CAPELLER). 
Verz. d. B. H. 	(PW) WEBER, Verzeichniss der Berliner Handschriften. 
Verz. d. Oxf. H.	(PW) AUFRECHT, Verzeichniss der Oxforder Handschriften. 
Vet. (U.)      	(PW) VETĀLAPAÑCA VIṂŚATIKĀ, herausgegeben von HEINRICH UHLE. 
Vet. (U.) S.   	[unknown]
Viddh.         	(PW) VIDDHAŚĀLABHAÑJIKĀKHYANĀṬIKĀ in der Zeitschrift PRATNAKAMRANANDINI(CAPELLER). 
Viddhaś.       	[unknown]
Viddhaśāl.     	[unknown]
Viddhaśālabh.  	[unknown]
Vijñ.          	(PW) [unknown literary source]
Vikr.          	(PW) VIKRAMORVAŚĪ, Ausg. von BOLLENSEN. 
Vikram.        	[unknown]
Vikramāṅkac.   	(PW) VIKRAMĀṄKADEVACARITA, Ausg. von BÜHLER. 
Vīram.         	(PW) VĪRAMITRODAYA, Khadirapura 1815(STENZLER) . 
Vīramitrodaya  	(PW) [unknown literary source]
Viṣṇubh.       	(SCH) Viṣṇubh(aktikalpalatā) ed. Kāvyamālā Nr. 31, Bombay 1892.
Viṣṇus.        	(PW) VIṢṆUSŪTRA, zur Herausgabe vorbereitet von Y. JOLLY (JOLLY) 
Viṣṇusm.       	[unknown]
Viṣṇusmṛti     	[unknown]
Vivādar.       	[unknown]
Vivādaratn.    	[unknown]
Vivādaratnākara	[unknown]
Vop.           	(PW) VOPADEVA'S MUGDHABODHA, herausgegeben und erklärt von O. BÖHTLINGK. 
VP.            	(PW) VIṢṆUPURĀṆA ed. Bomb. 
Vṛṣabh.        	(PW) VṚṢABHĀNUJA im 3ten und 4ten Bande des Pandit (CAPELLER). 
VS.            	(PW) VĀJASANEYISAṂHITĀ (ROTH und WEBER). 
VS. Prāt.      	(PW) PRĀTIŚĀKHYA zu VS in Ind. St. 4. 
Vyutp.         	(PW) VYUTPATTI, ein Sanskrit-Tibetisches Wörterbuch aus dem TAÑJUR (SCHIEFNER). 
Wilson, Sel. W.	(PW) Select Works of H. H. WILSON. 
Wilson, Sel. Works	[unknown]
Y.             	(SCH) Y(aśodhara's) Kommentar zum Kāmasūtram.
Yājñ.          	(PW) YĀJÑAVALKYA's Gesetzbuch, Ausg. von STENZLER. 
Yaśastilakam.  	[unknown]
Yogas.         	(PW) YOGASŪTRA. 
Yogavās.       	[unknown]
Yudh.          	(SCH) Yudh(iṣṭhiravijaya) ed. Kāvjamālā.
Zach.          	(PW) [unknown literary source]
ZDMG           	[unknown]
